111111111111111111111
1P0000000000000000E01
100011111011111110011
1000C00010000000C0001
101111000111110011111
1000000000N0000000001
100011110011111110001
1000C00000000000C0001
101111111011111111111
100000000000000000001
111111111111111111111