1111111111111111111111111111111111111111
1P000000000000C000000C0000000000000000E1
1010010100100000101001000000010101000101
1010010010101010001001000000010101000101
1000000000C00C00000000000000000000000C01
1010010100100000101001000000010101000101
1010010010101010001001000000010101000101
1C0000000000000C00000C000000000000000001
1010010100100000101001000000010101000101
1010010010101010001001000000010101000101
1000000000C00C00000000000000000000000C01
1010010100100000101001000000010101000101
1010010010101010001001000000010101000101
100000000000000C00000C0000000000000000C1
1111111111111111111111111111111111111111