1111111111111111111111111111111111
1E0000000000000C00000C000000000001
1110010100100000101001000000010101
1110010010101010001001000000010101
10000000C00C0000000C00000000C001C1
100000000000000C00C000000000000001
1C00000C0000000C00000C000000000001
1110010100100000101001000000010101
1010010010101010001001000000010101
1P0000000C00C000000000000000C001C1
1111111111111111111111111111111111